SO  ./Texture/stone.xpm

NO     ./Texture/wall.xpm

EA ./Texture/tex3.xpm

WE   ./Texture/tex2.xpm




F      220,100,0

C  225,30,0




111111111111111
100000000000001
100001000100001
100000001100001
1000000E0000001
100000000000001
100000000000001
111111111111111
