111111111111111
100000000000001
100001000100001
100000001100001
1000000N0000001
100000000000001
100000000000001
111111111111111
